{
  "tiles": [
    ["00","00","00","00","00","00","00","00","00","00","00","00","00","00","00","00","00","00"],
    ["00","00","00","00","00","00","00","00","00","00","00","00","00","00","00","00","00","00"],
    ["00","00","00","10","10","10","10","00","00","00","00","00","00","00","00","00","00","00"],
    ["00","00","10","10","00","00","10","00","00","00","00","00","00","00","00","10","00","00"],
    ["00","00","10","00","00","00","10","00","00","00","00","00","10","10","10","10","00","00"],
    ["10","10","10","00","00","00","10","00","00","00","00","10","10","00","00","00","00","00"],
    ["00","00","00","00","00","00","10","00","00","00","00","10","00","00","00","00","00","00"],
    ["00","00","00","00","00","00","10","10","00","00","10","10","00","00","00","00","00","00"],
    ["00","00","00","00","00","00","00","10","00","00","10","00","00","00","00","00","00","00"],
    ["00","00","00","00","00","00","00","10","10","10","10","00","00","00","00","00","00","00"],
    ["00","00","00","00","00","00","00","00","00","00","00","00","00","00","00","00","00","00"]
  ],
  "codes": {
    "00": "square",
    "01": "squareDeco",
    "10": "path"
  }
}
