{
  "tiles": [
    ["00","00","00","00","00","00","00","00","00","00","00","00","00","00","00","00","00","00","00"],
    ["00","00","00","00","00","00","00","00","00","00","00","00","00","00","00","00","00","00","00"],
    ["00","00","00","10","10","10","10","00","00","00","00","00","00","00","00","00","00","00","00"],
    ["00","00","10","10","00","00","10","00","00","00","00","00","00","00","00","10","00","00","00"],
    ["00","00","10","00","00","00","10","00","00","00","00","00","10","10","10","10","00","00","00"],
    ["10","10","10","00","00","00","10","00","00","00","00","10","10","00","00","00","00","00","00"],
    ["00","00","00","00","00","00","10","00","00","00","00","10","00","00","00","00","00","00","00"],
    ["00","00","00","00","00","00","10","10","00","00","10","10","00","00","00","00","00","00","00"],
    ["00","00","00","00","00","00","00","10","00","00","10","00","00","00","00","00","00","00","00"],
    ["00","00","00","00","00","00","00","10","10","10","10","00","00","00","00","00","00","00","00"],
    ["00","00","00","00","00","00","00","00","00","00","00","00","00","00","00","00","00","00","00"]
  ],
  "codes": {
    "00": "grass",
    "10": "path"
  }
}
